X,_,_,_,_,_,_,_,_,X
_,X,_,_,_,_,_,_,X,_
_,_,X,_,_,_,_,X,_,_
_,_,_,_,_,_,X,_,_,_
_,_,_,_,X,_,_,_,X,X
X,X,_,_,_,X,_,_,_,_
_,_,_,X,_,_,_,_,_,_
_,_,X,_,_,_,_,X,_,_
_,X,_,_,_,_,_,_,X,_
X,_,_,_,_,_,_,_,_,X