_,X,_,_,_,X,_,_,_,X
_,X,_,X,_,X,_,X,_,X
_,X,_,X,_,X,_,X,_,X
_,X,_,X,_,X,_,X,_,X
_,X,_,X,_,X,_,X,_,X
_,X,_,X,_,X,_,X,_,X
_,X,_,X,_,X,_,X,_,X
_,X,_,X,_,X,_,X,_,X
_,X,_,X,_,X,_,X,_,X
_,_,_,X,_,_,_,X,_,_