X,_,X,_,X,_,X,_,X,_
_,_,_,_,_,_,_,_,_,_
_,X,_,X,_,X,_,X,_,X
_,_,_,_,_,_,_,_,_,_
X,_,X,_,X,_,X,_,X,_
_,_,_,_,_,_,_,_,_,_
_,X,_,X,_,X,_,X,_,X
_,_,_,_,_,_,_,_,_,_
X,_,X,_,X,_,X,_,X,_
_,_,_,_,_,_,_,_,_,_